1111111111111111111111111111111111111111
1000C0C0C0C00P00000000000000000000000011
1000000C0C1C1C0000000000000000000CCCC011
10C0C0C0C1E1000000000000000000000CCCC011
1000000000C0C0C0C0C00C0C0C0C0C0C00C0C0C1
1111111111111111111111111111111111111111