11111111
101E1011
101010P1
101C0001
11111111